A/C|AMA DE CASA|||
ABASTEC|ABASTECEDOR|||
ABOG|ABOGADO|3||
ACOPIAD|ACOPIADOR|||
ACTOR|ACTOR|||
ACTRIZ|ACTRIZ|1||
ADIESTR|ADIESTRADOR|||
ADMINIS|ADMINISTRADOR|1||
AFILADO|AFILADOR|||
AG INM|AGENTE INMOBILIARIA|1||
AG MAR|AGENTE MARITIMO|||
AG POL|AGENTE DE POLICIA|||
AG SANI|AGENTE SANITARIO|||
AG SEG|AGENTE DE SEGUROS|1||
AG VIAJ|AGENTE DE VIAJES|1||
AGENTE|AGENTE|||
AGRIC|AGRICULTOR|1||
AGRIM|AGRIMENSOR|1||
AGRON|AGRONOMO|1||
AGROPEC|AGROPECUARIO|||
AGROTEC|AGROTECNICO|1||
AJ MEC|AJUSTADOR MECANICO|||
AJUSTAD|AJUSTADOR|||
ALAMBR|ALAMBRADOR|||
ALBAÑIL|ALBAÑIL|||
ALFAR|ALFARERO|||
ALMACEN|ALMACENERO|1||
ANA QUI|ANALISTA QUIMICO|1||
ANA SIS|ANALISTA DE SISTEMAS|1||
ANALIST|ANALISTA|1||
ANEST|ANESTESISTA|||
ANTENIS|ANTENISTA|||
ANTROPO|ANTROPOLOGO/A|1||
AP AGRO|APRENDIZ AGRO|||
AP ALB|APRENDIZ ALBAÑIL|||
APICULT|APICULTOR|||
APREND|APRENDIZ|||
ARADOR|ARADOR|||
ARCHIV|ARCHIVISTA|1||
ARMADOR|ARMADOR|||
ARMERO|ARMERO|||
ARQUEOL|ARQUEOLOGO|||
ARQUIT|ARQUITECTO|1||
ARRENDA|ARRENDATARIO|||
ARRIERO|ARRIERO|||
ARROCE|ARROCERO|||
ARTES|ARTESANO|||
ARTILL|ARTILLERO|||
ARTISTA|ARTISTA|1||
ARZOB|ARZOBISPO|||
AS SOCI|ASISTENTE SOCIAL|1||
ASEGUR|ASEGURADOR|1||
ASERR|ASERRADOR|||
ASESOR|ASESOR|1||
ASIS LA|ASISTENTE DE LABORATORIO|||
ASIST|ASISTENTE|1||
ASP MIL|ASPIRANTE MILITAR|1||
ASP NAV|ASPIRANTE NAVAL|1||
ASP POL|ASPIRANTE POLICIA|1||
ASPIRAN|ASPIRANTE|||
ASTROL|ASTROLOGO|||
ASTRON|ASTRONOMO|||
AUDITOR|AUDITOR|1||
AURIGA|AURIGA|||
AUTONO|AUTONOMO|1||
AUX ENF|AUXILIAR ENFERMERO|||
AUXIL|AUXILIAR|||
AVI AGR|AVICULTOR AGRICULTOR|||
AVI COM|AVIADOR COMERCIAL|||
AVI GAN|AVICULTOR GANADERO|||
AVI RET|AVIADOR RETIRADO|||
AVIADOR|AVIADOR|||
AVICUL|AVICULTOR|||
AY ALB|AYUDANTE ALBAÑIL|||
AY CAMP|AYUDANTE CAMPO|||
AY CARP|AYUDANTE CARPINTERIA|||
AY HERR|AYUDANTE HERRERO|||
AY MEC|AYUDANTE MECANICO|||
AY PAN|AYUDANTE PANADERIA|||
AY PINT|AYUDANTE DE PINTOR|||
AYU COC|AYUDANTE DE COCINA|||
AYUDANT|AYUDANTE|||
AZAFATA|AZAFATA|||
AZULEJ|AZULEJISTA|||
BACH|BACHILLER|1||
BAILAR|BAILARIN|||
BALDOS|BALDOSISTA|||
BALSERO|BALSERO|||
BANC|BANCARIO|||
BANQ|BANQUERO|||
BARMAN|BARMAN|||
BIBLIOT|BIBLIOTECARIO|1||
BICICL|BICICLETERO|||
BIOLOG|BIOLOGO/A|1||
BIOLOGA|BIOLOGA|1||
BIOQ|BIOQUIMICO|1||
BOBINAD|BOBINADOR|||
BODEG|BODEGERO|||
BOMBERO|BOMBERO|||
BORDAD|BORDADORA|||
BOX|BOXEADOR|||
BROMAT|BROMATOLOGO|1||
BRUJUL|BRUJULERO|||
CABAÑER|CABAÑERO|||
CABO|CABO|||
CACIQUE|CACIQUE|||
CAD|CADETE|||
CAD COM|CADETE COMERCIO|||
CAD MAR|CADETE DE MARINA|||
CAD MIL|CADETE MILITAR|||
CADNAV|CADETE NAVAL|||
CAFET|CAFETERO|||
CAJONER|CAJONERO|||
CALDER|CALDERERO|||
CALERO|CALERO|||
CAM FED|CAMARISTA FEDERAL|||
CAMARE|CAMARERO|||
CAMAROG|CAMAROGRAFO|||
CAMBIST|CAMBISTA|1||
CAMION|CAMIONERO|||
CANILL|CANILLITA|||
CANTAN|CANTANTE|1||
CANTIN|CANTINERO|||
CAÑISTA|CAÑISTA|||
CAPATAZ|CAPATAZ|||
CARBONE|CARBONERO|||
CARNIC|CARNICERO|||
CARP|CARPINTERO|||
CARRERO|CARRERO|||
CARTERO|CARTERO|||
CARTON|CARTONERO|||
CASERO|CASERO|||
CATEQ|CATEQUISTA|1||
CAZADOR|CAZADOR|||
CEMENTI|CEMENTISTA|||
CERAMIS|CERAMISTA|||
CERRAJ|CERRAJERO|1||
CHACAR|CHACARERO|||
CHACIN|CHACINADOR|||
CHANGAD|CHANGADOR|||
CHAP|CHAPISTA|||
CHEF|CHEF|||
CHOF|CHOFER|||
CIENTIF|CIENTIFICO|1||
CIRCEN|TRABAJADOR DE CIRCO|||
CITRIC|CITRICULTOR|||
CL FRUT|CLASIFICADOR FRUTAS|||
CLERIGO|CLERIGO|||
CLOAQ|CLOAQUISTA|||
COBR|COBRADOR|1||
COCIN|COCINERO|||
COLCHON|COLCHONERO|||
COM SOC|COMUNICADOR SOCIAL|1||
COMERC|COMERCIANTE|1||
COMIS|COMISIONISTA|1||
COND CA|CONDUCTOR DE CARROS|||
CONDUCT|CONDUCTOR|1||
CONFEC|CONFECCIONISTA|||
CONFIT|CONFITERO|||
CONST|CONSTRUCTOR|1||
CONTABL|CONTABLE|1||
CONTACT|CONTACTOLOGO|1||
CONTAD|CONTADOR PUBLICO|1||
CONTRAT|CONTRATISTA|1||
COOPER|COOPERATIVISTA|1||
COR COF|CORTE Y CINFECCION|||
CORRED|CORREDOR|||
CORTAD|CORTADOR|||
COSECH|COSECHADOR|||
COSMETO|COSMETOLOGA|1||
COSTUR|COSTURERA|1||
CRIADOR|CRIADORA|||
CUIDAD|CUIDADOR|||
CUNICUL|CUNICULTOR|||
CURTID|CURTIDOR|||
D JOKEY|DISCK JOCKEY|1||
DACTI|DACTILOSCOPO/A|||
DACTIL|DACTILOGRAFO|1||
DECOR|DECORADOR|1||
DEPEND|DEPENDIENTE|||
DEPORT|DEPORTISTA|1||
DEPOST|DEPOSTADOR|||
DES ADU|DESPACHADOR ADUANA|1||
DESCART|DESCARTADOR|||
DESMONT|DESMONTADOR|||
DESOCUP|DESOCUPADO|1||
DIACONO|DIACONO|||
DIARERO|DIARERO|||
DIBUJ|DIBUJANTE|1||
DIPLOM|DIPLOMATICO|||
DIRECT|DIRECTOR|1||
DISCAP|DISCAPACITADO|||
DISEÑ|DISEÑADOR|1||
DISTRIB|DISTRIBUIDOR|||
DOCENTE|DOCENTE|1||
DOCT CN|DOCTOR EN CIENCIAS NAT.|1||
DOMADOR|DOMADOR|||
DR BIOL|DOCTORADO EN BIOLOGIA|1||
DR ECON|DR CIENCIAS ECONOMICAS|1||
EBANIS|EBANISTA|||
ECOLOG|ECOLOGA/O|1||
ECON|ECONOMISTA|1||
EDIT|EDITOR|1||
EDUCAC|EDUCACIONISTA|1||
EJECUT|EJECUTIVO|1||
ELE MEC|ELECTROMECANICO|1||
ELE TEC|ELECTROTECNICO|1||
ELECT|ELECTRICISTA|||
EM CONS|EMPLEADO CONSTRUCCION|||
EM FFCC|EMPLEADO DE FERROCARRIL|||
EMBALAD|EMBALADOR|||
EMBARC|EMBARCADO|||
EMP COM|EMPLEADO COMERCIO|1||
EMP DOM|EMPLEADA DOMESTICA|||
EMP ENC|EMPLEADO ENCOTEL|1||
EMP FAA|EMPLEADO FUERZAS ARMADAS|1||
EMP MAR|EMPLEADO MARITIMO|1||
EMP MIL|EMPLEADO MILITAR|1||
EMP POL|EMPLEADO DE POLICIA|1||
EMP RUR|EMPLEADO RURAL|||
EMP TEL|EMPLEADO TELEFONO|1||
EMPAQUE|EMPAQUETADOR|||
EMPL|EMPLEADO|1||
EMPRES|EMPRESARIO|1||
ENC CPO|ENCARGADO DE CAMPO|1||
ENC RUR|ENCARGADO RURAL|||
ENCARG|ENCARGADO|1||
ENCOFRA|ENCOFRADOR|||
ENCUAD|ENCUADERNADOR|||
ENFERME|ENFERMERO|||
ENGRAS|ENGRASADOR|||
ENOLOGO|ENOLOGO|1||
ENT DEP|ENTRENADOR DEPORTIVO|1||
ESCOB|ESCOBERO|||
ESCRIB|ESCRIBANO|1||
ESCRIT|ESCRITOR|1||
ESCULT|ESCULTOR|1||
ESQUIL|ESQUILADOR|||
ESTANC|ESTANCIERO|||
ESTETIC|ESTETICISTA|||
ESTIB|ESTIBADOR|||
ESTILIS|ESTILISTA|||
ESTUD|ESTUDIANTE|1||
EXP AUT|EXPERTO EN AUTOMOTORES|||
FABRIC|FABRICANTE|||
FAENA|FAENADOR|||
FARMAC|FARMACEUTICO|2||
FERIA|FERIANTE|||
FERRET|FERRETERO|1||
FERROVI|FERROVIARIO|||
FINANC|FINANCISTA|||
FISIOT|FISIOTERAPEUTA|1||
FLET|FLETERO|||
FLORIC|FLORICULTOR-FLORISTA|||
FOGUI|FOGUISTA|||
FONOAUD|FONOAUDIOLOGO|1||
FOREST|FORESTADOR|||
FOTOG|FOTOGRAFO|1||
FRUTIC|FRUTICULTOR|||
FUMIG|FUMIGADOR|||
FUNCION|FUNCIONARIO|||
FUTBOL|FUTBOLISTA|1||
GANAD|GANADERO|1||
GASISTA|GASISTA|||
GASTR|GASTRONOMO|1||
GEN RET|GENDARME RETIRADO|||
GEND|GENDARME|||
GEOFIS|GEOFISICO|1||
GEOLOG|GEOLOGO|1||
GERENTE|GERENTE|1||
GERONT|GERONTOLOGO|1||
GESTOR|GESTOR|1||
GOMERO|GOMERO|||
GRAFICO|GRAFICO|||
GRANJ|GRANJERO|1||
GUA CAR|GUARDIA CARCEL|||
GUAR PA|GUARDA PARQUE NACIONAL|1||
GUARDA|GUARDA|||
GUARDAP|GUARDA PARQUE|||
GUI MON|GUIA DE MONTAÑA|1||
GUI TUR|GUIA TURISMO|1||
HACEND|HACENDADO|||
HACHERO|HACHERO|||
HELAD|HELADERO|||
HERRERO|HERRERO|||
HILAND|HILANDERA|||
HOJAL|HOJALATERO|||
HORTIC|HORTICULTOR|||
HOTELER|HOTELERO|||
IMPRES|IMPRESOR|1||
INCAPAC|INCAPACITADO|||
INDEP|INDEPENDIENTE|1||
INDUST|INDUSTRIAL|1||
INFORM|INFORMATICO|||
ING|INGENIERO|1||
ING AGR|ING AGRIMENSOR O AGRONOMO|1||
ING CIV|INGENIERO CIVIL|1||
ING CON|INGENIERO EN CONSTRUCCION|1||
ING ELE|INGENIERO ELECTRONICA|1||
ING FOR|INGENIERO FORESTADOR|1||
ING GEO|INGENIERO GEOGRAFO|1||
ING IND|INGENIERO INDUSTRIAL|1||
ING MEC|INGENIERO MECANICO|1||
ING MEL|INGENIERO MECANICO ELECTR|1||
ING NAV|INGENIERO NAVAL|1||
ING QUI|INGENIERO QUIMICO|1||
ING SIS|INGENIERO EN SISTEMAS|1||
ING ZOO|INGENIERO ZOOTECNISTA|1||
INMOB|INMOBILIARIO|1||
INSPEC|INSPECTOR|1||
INST DA|INSTRUCTOR/A DANZA|||
INSTAL|INSTALADOR|||
INSTRUC|INSTRUCTOR|1||
INSTRUM|INSTRUMENTISTA|1||
JARDIN|JARDINERO|||
JEF HOG|JEFA Y JEFE DE HOGAR|||
JOCKEY|JOCKEY|||
JORN|JORNALERO|||
JOYERO|JOYERO|1||
JUB|JUBILADO|||
JUEZ|JUEZ|||
KINESIO|KINESIOLOGO|1||
LABORAT|LABORATORISTA|1||
LABORES|LABORES|||
LABRAD|LABRADOR|||
LADRIL|LADRILLERO|||
LAVADOR|LAVADOR|||
LAVAND|LAVANDERA|||
LECHERO|LECHERO|||
LEÑADOR|LEÑADOR|||
LETRIST|LETRISTA|1||
LIC ADM|LICENCIADO EN ADMINISTRAC|1||
LIC COM|LICENC. EN COMERC. EXT.|1||
LIC CRI|LICENCIADO CRIMINALISTICA|1||
LIC SIS|LICENCIADO EN SISTEMAS|||
LIC ZOO|LICENCIADO ZOOLOGIA|1||
LICEN|LICENCIADO|1||
LINOTIP|LINOTIPISTA|||
LOCADOR|LOCADOR|1||
LOCUTOR|LOCUTOR|1||
LUST BO|LUSTRABOTAS|||
LUSTRAD|LUSTRADOR|||
LUTHIER|LUTHIER|||
M M OBR|MAESTRO MAYOR DE OBRAS| ||
MA PAST|MAESTRO PASTELERO|||
MACHIM|MACHIMBRERO|||
MADER|MADERERO|||
MAE|MAESTRANZA|||
MANDAD|MANDADERO|||
MANDAT|MANDATARIO|||
MANICUR|MANICURA|1||
MANIPUL|MANIPULADORA|||
MAQUIN|MAQUINISTA|||
MAR MER|MARINO MERCANTE|||
MAR RET|MARINO RETIRADO|||
MARINER|MARINERO|||
MARINO|MARINO|||
MARKET|MARKETING|||
MARMOL|MARMOLERO|||
MARROQ|MARROQUINERO|||
MARTILL|MARTILLERO PUBLICO|1||
MASAJ|MASAJISTA|||
MATARIF|MATARIFE|||
MATRIC|MATRICERO|||
MAYORD|MAYORDOMO|||
MEC|MECANICO| ||
MEC AUT|MECANICO AUTOMOTRIZ| ||
MEC DEN|MECANICO DENTAL|1||
MEC TOR|MECANICO TORNERO|||
MEDICO|MEDICO/A|||
METALUR|METALURGICO|||
MIL RET|MILITAR RETIRADO|||
MILITAR|MILITAR|||
MIMBRE|MIMBRERO|||
MINERO|MINERO|||
MISION|MISIONERO|||
MODELO|MODELO|1||
MODISTA|MODISTA|||
MOSAIST|MOSAISTA|||
MOTORIS|MOTORISTA|||
MOTOSIE|MOTOSIERRISTA|||
MOZO|MOZO|||
MUCAMA|MUCAMA|||
MUEBL|MUEBLERO|||
MUSEOLO|MUSEOLOGO|1||
MUSICO|MUSICO|1||
NAVEG|NAVEGANTE|||
NIÑERA|NIÑERA|||
NIQUEL|NIQUELADOR|||
NOTARIO|NOTARIO|1||
NOVID|NO VIDENTE|||
NUTRIC|NUTRICIONISTA|1||
OBR RUR|OBRERO RURAL|||
OBRAJ|OBRAJERO|||
OBRERO|OBRERO/A|||
ODONT|ODONTOLOGO|1||
OF ALB|OFICIAL ALBAÑIL|||
OF CARP|OFICIAL CARPINTERO|||
OF MECA|OFICIAL MECANICO|||
OF PANA|OFICIAL PANADERO|||
OFTALM|OFTALMOLOGO|1||
OPERAD|OPERADOR|||
OPERARI|OPERARIO|||
OPTICO|OPTICO|1||
ORDENAN|ORDENANZA|||
ORUGUIS|ORUGUISTA|||
PALEADO|PALEADOR|||
PANADER|PANADERO|||
PANIF|PANIFICADOR|||
PANTAL|PANTALONERA|||
PARQUET|PARQUETISTA|||
PARTERA|PARTERA|||
PAS EVA|PASTOR EVANGELICO|||
PASTEL|PASTELERO|||
PASTOR|PASTOR/A GANADO MENOR|||
PE AGRO|PERITO AGRONOMO|1||
PEDAG|PEDAGOGA|1||
PEDICU|PEDICURA|1||
PEINADO|PAINADORA|||
PEL.ANI|PELUQUERO DE ANIMALES|||
PELET|PELETERO|||
PELUQUE|PELUQUERA|1||
PENS|PENSIONADO|||
PEON|PEON|||
PER ECO|PERITO RECURSOS NAT.Y ECOLOG.|1||
PER MER|PERITO MERCANTIL|1||
PERFORA|PERFORADOR|||
PERIOD|PERIODISTA|1||
PESCAD|PESCADOR|||
PILOTO|PILOTO|||
PINTOR|PINTOR|||
PLANCHA|PLANCHADORA|||
PLATERO|PLATERO|||
PLOMERO|PLOMERO|||
PNA RET|RETIRADO DE PREFECTURA|||
PODOL|PODOLOGO|1||
POL RET|POLICIA RETIRADO|1||
POL.AER|POLICIA AERONAUTICA|||
POL.FED|POLICIA FEDERAL|||
POLICIA|POLICIA|||
PORCIC|PORCICULTOR|||
PORTER|PORTERO/A|||
POSGRAD|CON POSGRADO|||
POTRERI|POTRERIZO|||
PRECEPT|PRECEPTOR/A|||
PREF NA|PREFECTO NAVAL|||
PREVENT|PREVENTISTA|1||
PRO SIS|PROGRAMADOR DE SISTEMAS|1||
PROCUR|PROCURADOR|1||
PRODUCT|PRODUCTOR|1||
PROF|PROFESOR|1||
PROMOT|PROMOTOR|1||
PROTES|PROTESISTA|||
PSICOAN|PSICOANALISTA|1||
PSICOLO|PSICOLOGO|1||
PSICOMO|PSICOMOTRICISTA|||
PSICOPE|PSICOPEDAGOGA/O|1||
PSIQUIA|PSIQUIATRA|||
PUBLIC|PUBLICISTA|1||
PUESTER|PUESTERO|||
PULIDOR|PULIDOR|||
QS DS|QUEHACERES DOMESTICOS|2||
QUIMICO|QUIMICO|1||
RABINO|RABINO|||
RAD OPE|RADIO OPERADOR|1||
RAD TEC|RADIO TECNICO|1||
RADIOL|RADIOLOGO|1||
REGADOR|REGADOR|||
RELIGIO|RELIGIOSA|||
RELOJ|RELOJERO|1||
REMAT|REMATADOR|||
REMIS|REMISERO|||
RENTIST|RENTISTA|||
REP GRA|REPORTERO GRAFICO|||
REPRES|REPRESENTANTE|1||
RESTAUR|RESTAURADOR|||
ROTISER|ROTISERO/A|||
RRPP|RELACIONES PUBLICAS|||
RURAL|RURAL|||
S/P|SIN PROFESION|||
SACAROT|SACAROTECNICO|||
SACERDO|SACERDOTE|||
SACRIST|SACRISTAN|||
SANIT|SANITARISTA|||
SARGENT|SARGENTO|||
SASTRE|SASTRE|1||
SECRET|SECRETARIA|1||
SEGURID|SEGURIDAD PRIVADA|||
SEMINAR|SEMINARISTA|||
SER DOM|SERVICIO DOMESTICO|||
SERENO|SERENO|||
SERVPEN|SERVICIO PENITENCIARIO FEDERAL|2||
SINFIN|SINFINERO|||
SOCIOL|SOCIOLOGO|2||
SODERO|SODERO|||
SOLD|SOLDADOR|||
SOLDADO|SOLDADO|||
SOMBRER|SOMBRERERO|||
SONIDIS|SONIDISTA|1||
SOPLETE|SOPLETERO|||
SUBOFIC|SUBOFICIAL|||
SUPERV|SUPERVISOR|||
T AD EM|TECNICO ADM. DE EMPRESA|1||
T TELEC|TEC.EN TELECOMUNICACIONES|1||
TABAC|TABACALERO|||
TAGUIGR|TAQUIGRAFO/A|||
TALAB|TALABARTERO|||
TAMBERO|TAMBERO|||
TAPICE|TAPICERO|||
TAXI|TAXISTA|||
TE QUIM|TECNICO QUIMICO|1||
TE RADI|TECNICO EN RADIO|1||
TEC AER|TECNICO AERONAUTICO|1||
TEC AGR|TECNICO AGROPECUARIO|1||
TEC AUT|TECNICO AUTOMOTOR|1||
TEC BAN|TECNICO BANCARIO|1||
TEC CON|TECNICO EN CONSTRUCCION|1||
TEC ELC|TECNICO ELECTRONICO|1||
TEC ELM|TECNICO ELECTOMECANICO|1||
TEC IND|TECNICO INDUSTRIAL|1||
TEC MEC|TECNICO MECANICO|1||
TEC MIN|TECNICO EN MINAS|1||
TEC ORT|TECNICO ORTOPEDICO|1||
TEC PET|TECNICO EN PETROLEO|1||
TEC RAD|TECNICA RADIOLOGA|1||
TEC TUR|TECNICO EN TURISMO|1||
TECNICA|TECNICA|1||
TECNICO|TECNICO|1||
TEJEDOR|TEJEDORA|||
TELECOM|TELECOMUNICADOR|1||
TELEGR|TELEGRAFISTA|1||
TELERO|TELERO/A|||
TEN LIB|TENEDOR DE LIBROS|||
TEO|TEOLOGO|1||
TEXTIL|TEXTIL|1||
TINTORE|TINTORERO|1||
TIPOGR|TIPOGRAFO|1||
TOPAD|TOPADORISTA|||
TOPOGR|TOPOGRAFO|1||
TORNERO|TORNERO|||
TR GRAL|TAREAS GENERALES|||
TR RURA|TRABAJADOR RURAL|||
TRACT|TRACTORISTA|||
TRADUCT|TRADUCTORA|1||
TRANSP|TRANSPORTISTA|||
TRILLAD|TRILLADOR|||
TRONERO|TRONERO|||
VEN AMB|VENDEDOR AMBULANTE|||
VENDED|VENDEDOR|1||
VERDUL|VERDULERO|||
VET GUE|VETERANO DE GUERRA|||
VETER|VETERINARIO|1||
VIAJANT|VIAJANTE|1||
VIDRIER|VIDRIERO|||
VIG PRI|VIGILANCIA PRIVADA|||
VIS MED|VISITADOR MEDICO|1||
VITIC|VITICULTOR|||
VULCANI|VULCANIZADOR|||
YESERO|YESERO|||
ZAFRERO|ZAFRERO|||
ZAPAT|ZAPATERO|||
ZOOTEC|ZOOTECNICO|1||
